XX0XXXX0XXXX
XXBXXXXBXXXX
E100XP00XXXX
XXX0XXX0XXXX
00000D000DR0
0XX0XXXXXXXX
DXX00M0DT0XX
RXXXXXXXXXXX
PXXXXXXXXXXX